XXXXXXXXXXXXXXXXXXXXXXXXXXXXXXXXXXXXXXXXXXXXXXXXXXXXXXXXXXXXXXXXXXXXXXXXXXXXXXXXXXXXXXXX
X X X X XX X X X X X X X X X X X X XXXX X X X XXXXXX X X X XXXXXXXXXXXX X X X  X X X  XX
XS  X   X    X   X           X     X  X X X    XXXX         XX     XX X        X       X
X   X        X         XX      X      X    X   X      XX   XXXXXX       XX     X  X  XXX
XX      XXX      XXXX        XX  X X  X X       X X           XXX   X X     X X X  X   X
XX   XXXXXXXXX   X      X          X         X X X   X X XXXXXXX    X    XX   X       XX
X                               X        X               X X X               XX     XXXX
X X             XXXXXX         XX    XXX          XXXXXX        XXX         XX         X
XX XXXXXXXXXXXX   X X                      XXX                       X XX X X X X XXXXXX
X                      XXXXXXX    X X X  X          X XXXX X X X       XX             XX
XXXXXXXXXXXXXXX          XXXXXXXXXX   XXXXXXXXXXXXX          XXX          XX   XXXXXXXXX
X X XXXXXX X       X X                   X X           X   X X X         XXXX XXXXXXXXXX
XXX            XXXXXXXXXX XXXXXXXXXXXXXXXXXX   XXXXXXXXXXXXX     XXXXXXXXX       XXXX  X
XXXXXXXXXXX X X XXXX X X X XXXXXX X X X XXXXXXXXXXXX X X XXXX X X X XXXXXX X X X XXXXXXX
XX X X XXXX X X X XXXXXX X X X XXXXXXXXXXXX X X XXXX X X X XXXXXX X X X XXXXXXXXXXX    X
X                X X X XXXX X X X XXXXXX X X X XXXXXX            X X X XXXX X X X XXXXXX
XXXXXX   XXXXXXXXXX X                             XXXXXXX X X             XXXX        XX
XXXXXXX                XXXXXXX         X                         X X XXX               X
XXXXXXXXXXXXX                               XXXXXXXXXXXXXX             XXXXXXXXXXXXX   X
XXX       XXX    X     XXXXXXXXX            X  X X X  X X X            X X X    X  X   X
XXXXXX                 XXX          XXXXXXX    X  X  X   X    X   XXX         XXX     EX
XXXXXXXXXXXXXXXXXXXXXXXXXXXXXXXXXXXXXXXXXXXXXXXXXXXXXXXXXXXXXXXXXXXXXXXXXXXXXXXXXXXXXXXX
